objetivo: 5 5
esqueleto: 3 4
mapa:
0 0 1 1 1 0
0 0 1 6 1 0
0 0 2 0 0 0
0 0 0 0 0 0
0 3 3 0 2 0
0 0 0 0 0 5

